11111111111111111111111111111
11111000000000110000000000001
11111011000001110000000000001
11111001000000000000000000001
11111011000001110000000000001
10000000001100000111011111111
111101111111110111000N0010001
11110111111111011101010010001
11000000110101011100000010001
10000000000000001100000010001
10000000000000001101010010001
11000001110101011111011110001
11110111111101011101111010001
11111111111111111111111111111
