  
                                NO                 ./texture/wall_light.xpm

WE                                           ./texture/wall_shadow.xpm
      
                        EA                                              ./texture/wall_shadow.xpm

  




SO                       ./texture/wall_light.xpm


F 85,60,40



C 190,188,175

111111111          111111111 1111111111
11111111111111111111111111101
111110000000001100000000000N1
11111011000001110000000000001
11111001000000000000000000001
11111011000001110000000000001
10000000001100000111011111111
11110111111111011100000010001
11110111111111011101010010001
11000000110101011100000010001
10000000000000001100000010001
10000000000000001101010010001
11000001110101011111011110001
11110111111101011101111010001
11111111111111111111111111111
